Duolingo: Language Lessons
EWA: Learn English & Spanish
Falou - Fast language learning
Quizlet: More than Flashcards
Busuu: Learn & Speak Languages
Cake - Learn English & Korean
Babbel - Learn Languages
AnkiDroid Flashcards
Wlingua - Learn Spanish
Rosetta Stone: Learn, Practice
Mondly: Learn 41 Languages
Learn German for beginners
Simpler: English learning app
ELSA Speak: English Learning
Memrise: Languages for life
Learn English - 11,000 Words
Wlingua - Learn English
Learn French - Speak French
Learn German - 11,000 Words
Learn German - Speak German
Learn Spanish for beginners
English Grammar Test
Learn English. Speak English
Learn French for beginners
LingoDeer - Learn Languages
WordUp | AI Vocabulary Builder
Learn Spanish. Speak Spanish
Flashcards World
Gizmo: AI Flashcards and Tutor
Vocabulary Builder - Test Prep
Learn English, Spanish: Learna
Learn Dutch - Speak Dutch
Drops: Language Learning Games
Andy English Language Learning
DuoCards - Vocabulary Builder
